
Lv. 3=Lv. 3
Lv. 2=Lv. 2
Lv. 1=Lv. 1
Lv. 5=Lv. 5
Lv. 4=Lv. 4

——头饰
None=无
Holy Knight Tiara=圣骑士头饰
Elemental Plume=元素羽流
Black Sun Crown=黑太阳冠
Shrine Maiden Headdress=巫女头饰
Fairy Flower=精灵花
Maid Headdress=女仆头饰
Bunny Ear Headband=兔耳头饰
Bridal Veil=新娘面纱
Bridal Tiara=新娘头饰
Fur-trimmed Nightcaps=圣诞帽
Mage Hat=魔法师帽
Doggy Ears=狗耳
Cat Ears=猫耳
Succubus Horns=魅魔角
Angelic Halo=天使光环

——服装
None=无
Holy Knight Breastplate=圣骑士胸甲
Elemental Armor=元素盔甲
Elemental Bodysuit=元素连体衣
Black Sun Armor=黑太阳盔甲
Holy Knight Dress=圣骑士礼服
Hand-Me-Downs=旧衣服
Sundress=背心裙
Shrine Maiden Tunic=巫女束腰
Shrine Maiden Tunic (Sleeveless)=巫女束腰（无袖）
Foreign Dress=旗袍
Otherworldly School Uniform=异世界校服
Maid Outfit=女仆装
Bridal Dress=婚纱
Bridal Bustier=新娘胸衣
Fur-trimmed Miniskirt=圣诞迷你裙
Bunny Suit=兔女郎装
Sexy Frilled Bra & Panties=性感褶边文胸和内裤
Otherworldly Swimsuit=异世界泳衣

——手饰
None=无
Holy Knight Gauntlets=圣骑士护臂
Elemental Gauntlets=元素手套
Black Sun Gauntlets=黑太阳手套
Holy Knight Long Gloves=圣骑士长手套
Armored Shrine Sleeves=盔甲圣袖
Shrine Maiden Sleeves=巫女袖
Brawler Gloves=拳击手手套
Maid Sleeves=女仆袖子
Gold-Buttoned Cuffs=金扣袖口
Doggy Paws=狗爪
Arm Wraps=护腕
Fairy Bracelets=精灵手环
Succubus Bracelets=魔女手镯

——腿部
None=无
Holy Knight Stockings=圣骑士过膝袜
Holy Knight Stockings & Garter=圣骑士吊带过膝袜
Elemental Boots=元素靴
Maid Knee Highs=女仆过膝袜
Hiking Socks=旅行袜
Socks=袜子
Pantyhose=连裤袜
Pantyhose & Panties=连裤袜&内裤
Fishnet Tights=渔网袜
Succubus' Garter Ring=魅魔腿环

——脚部
None=无
Holy Knight Leggings=圣骑士护腿
Black Sun Leggings=黑太阳护腿
Hiking Boots=旅行靴子
Miria's Boots=Miria的靴子
Foreign Armored Thigh-High Boots=异域装甲长筒靴
Thigh-High Boots=长筒靴
Mage Boots=法师靴
Otherworldly Shoes=异世界鞋
Pumps=轻软舞鞋
Maid Shoes=女仆鞋
High Heels=高跟鞋
Bridal Shoes=新娘鞋
Ricca's Sandles=Ricca的凉鞋
Fairy Anklets=精灵脚镯
Doggy Slippers=狗拖鞋

——背部
None=无
Holy Knight Cloak=圣骑士斗篷
Wind Cloak=风衣
Black Sun Cloak=黑太阳斗篷
Belt=腰带
Blue Scarf=蓝色围巾
Red Scarf=红色围巾
Decorative Round Shield=装饰圆盾
Holy Knight Wings=神圣骑士之翼
Fairy Wings=仙女之翼
Succubus Wings=魅翼

——胸罩
None=无
Ricca's Bra=Ricca的胸罩
Lace Bra=蕾丝胸罩
Striped Bra=条纹文胸
Bikini Top=比基尼上衣
Sexy Bra=性感文胸
Lewd Bra=诱惑文胸
Nipple Piercings=乳头穿孔
Heart Stickers=心形贴纸

——内裤
None=无
Ricca's Panties=Ricca的内裤
Lace Panties=蕾丝内裤
Striped Panties=条纹内裤
Side-Tie Panties=侧系带内裤
Bikini Bottoms=比基尼内裤
Sexy Panties=性感内裤
Lewd Panties=诱惑内裤
Clit Piercing=阴蒂穿刺

——尾部
None=无
Doggy Tail=狗尾巴
Cat Tail=猫尾巴
Doggy Tail (Plug)=狗尾巴（塞子）
Cat Tail (Plug)=猫尾 （塞子）
Bunny Tail=兔尾巴
Succubus Tail=魅魔尾巴

——眼部
None=无
Black Frame Glasses=黑框眼镜
Visor=面罩
Thief Mask=盗贼面具
Blindfold=蒙眼布
Succubus Earrings=魔女耳环

——颈部和胸部
None=无
Holy Knight Brooch=神圣骑士胸针
Fairy Choker=仙女项链
Succubus Crystal=魅魔水晶
Mage Pendant=魔法师吊坠
Succubus Choker=魅魔颈圈
【以上部分经过校对】
——武器
Holy Knight Greatsword=圣骑士巨剑
Holy Knight Greatsword／A greatsword given to the holy knight by the sun god.\r\nBoasts a good balance of weight and attack power. Decreases the cooldown time of special attacks when equipped.=圣骑士巨剑／太阳神送给圣骑士的一把巨剑。\n拥有良好的平衡的重量和攻击力。装备后减少特殊攻击的冷却时间。
Elemental Sword=元素剑
Elemental Sword／A blade blessed by spirits governing the elements of fire, lightning and ice.\r\nAn extremely light blade with a high attack speed. Raises resistance to all 3 elements when equipped.=元素之剑／由掌管火、闪电和冰元素的精灵祝福的剑。\n极轻的刀刃，攻击速度很快。在配备时提高对所有3种元素的抗性。
Black Sun Greatsword=黑太阳巨剑
Black Sun Greatsword／A long, heavy greatsword, unwieldable by the average warrior. \r\nIncreases damage of the 4th consecutive hit for weak and strong attacks, and the 3rd consecutive hit for weak aerial attacks.=黑太阳巨剑／一把又长又重的巨剑，一般战士难以驾驭。\n对于弱攻击和强攻击，增加第四次连击的伤害；对于弱空攻击，增加第三次连击的伤害。
White-Winged Holy Knight Greatsword=白翼的圣骑士巨剑
White-Winged Holy Knight Greatsword／The new form of the Holy Knight Greatsword which evolved in response to its wielders increase in power.\r\nWhen equipped, increases defense and reduces the cooldown time of special attacks.=白翼的圣骑士巨剑／新形式的圣骑士巨剑 它的进化是为了回应持用者力量的增加。\n装备后，增加防御并减少特殊攻击的冷却时间。
Heavenly Ōdachi=神圣大太刀
Heavenly Ōdachi／A blade offered in worship by people of the far east.\r\nConsecutive hits increase the blade's attack and knockback capabilities.=神圣大太刀／远东地区的人们用来祭拜的一把刀。\n连击时增加武器的攻击力和击退能力。
Spear of Retaliation=复仇之矛
Spear of Retaliation／A short spear engraved with magical runes. Capable of powerful thrusts, but only the tip is strong.\r\nDoes increased damage to enemies when they are struck mid-attack.=复仇之矛／刻有魔法符文的短矛。有强大的推力，但只有尖端是强大的。\n当敌人在攻击中被击中时，对他们造成更大的伤害。
Sunblaze Lance=沐浴日光之矛
Sunblaze Lance／A knight's lance emblazoned with markings representing the rays of the sun.\r\nCapable of powerful thrusts, but only the tip is strong. Strengthens the [Blaze Charge] special attack.=沐浴日光之矛／一种骑士的长矛，上面有代表太阳光线的标记。\n有强大的推力，但只有尖端是强大的。强化[火焰冲锋]特殊攻击。
Skeleton Warrior's Long Spear=骷髅战士长矛
Skeleton Warrior's Long Spear／A long spear, the weapon of a skeleton warrior.\r\nCapable of powerful thrusts, but only the tip is strong. Equip it to make it easier to perfect guards.=骷髅战士的长矛／长矛，骷髅战士的武器。\n有强大的推力，但只有尖端是强大的。装备它，能更容易完美格挡。
Grim Reaper Great-Scythe=死神大镰刀
Grim Reaper Great-Scythe／A large scythe belonging to the embodiment of death. Difficult to use due to its long blade that gets easily caught on terrain.\r\nWhen hitting a low HP enemy, it exceeds the scythe's base attack to finish them off.=死神大镰刀／属于死亡化身的大镰刀。很难使用，因为它的长刀片很容易在地形上卡住。\n当打击一个低血量的敌人时，它会超过镰刀的基础攻击力来消灭他们。
All attacks\r\nbecome finishers=所有攻击\n成为终结者
Orcish Club=兽人打击棍
Orcish Club／A giant club beloved of orcs. \r\nPounding attacks cause spikes to erupt from the ground.=兽人打击棍／兽人喜爱的大型打击棍。\n撞击攻击会导致尖刺从地面上喷发出来。
Warhammer of Tremors=震颤战锤
Warhammer of Tremors／A massive, heavy iron warhammer.\r\nWhen equipped, increases the wielder's defense. Pounding attacks cause small tremors.=震颤战锤／一种巨大、沉重的铁制战锤。\n装备后，增加持用者的防御。撞击会引起轻微的震动。
Mage Staff=法师杖
Mage Staff／A staff once used by a mage as a catalyst for casting spells.\r\nLengthens the duration of enchantments and greatly increases attack power for the duration.=法师杖（Mage Staff）／曾被法师用作施法催化剂的杖。\n延长附魔的持续时间，并在持续时间内显著增加攻击强度。
Necromancer Staff=亡灵法师杖
Necromancer Staff／A staff once used by a necromancer as a catalyst for casting spells.\r\nLengthens the duration of enchantments and greatly increases attack power for the duration.=亡灵巫师杖／曾被亡灵巫师用作施法催化剂的杖。\n延长附魔的持续时间，并在持续时间内显著增加攻击强度。

——【以上部分经过初步校对，可能有不妥之处】——



————————章节标题翻译【前置】
Writhing Sludge=扭动的污泥
Town of Undead=不死之城
In the Name of God's Knight=以上帝骑士的名义
The Depths of Darkness=黑暗的深处
Raging Downpour=倾盆大雨
Village Guardian=乡村守护者
The Witch and the Village Girl=女巫和乡村女孩
The Temple of Spiders=蜘蛛神庙
A Legend Resurrected=传奇不灭
The Demon God of the Abyss=深渊恶魔之神
Escalating Hope=越来越多的希望
The Fairy Tale Of Holy Knight Ricca=童话：圣骑士Ricca
The Ruler of Demons=恶魔的统治者
Lost Chapter=遗失的章节
Ricca Thereafter=Ricca的后来
Ricca Thereafter (Continued)=Ricca的后来（续）
Boney-Boney Challenge=Boney-Boney挑战赛
The Lord of Statues (Part 2)=雕像之王（下）
The Lord of Statues (Part 1)=雕像之王（上）
Birth of a Succubus=魅魔的诞生
The Dwellers of the Dark Forest=黑暗森林的居民
The Revived Stone Giant=复活的石头巨人
Red Stone=红魔法石
The Kidnapped Maiden=被绑架的少女
The Brooch of Sunlight=阳光胸针
Emissary of Sunlight=阳光的使者
————————副词
Highest=极高
Quite High=略高
High=高
Medium=中
Low=低
Quite Low=略低
——————穷举
File 1=文件 1
File 2=文件 2
File 3=文件 3
File 4=文件 4
File 5=文件 5
File 6=文件 6
File 7=文件 7
File 8=文件 8
File 9=文件 9
File 10=文件 10
Chapter 1=第 1 章
Chapter 2=第 2 章
Chapter 3=第 3 章
Chapter 4=第 4 章
Chapter 5=第 5 章
Chapter 6=第 6 章
Chapter 7=第 7 章
Chapter 8=第 8 章
Chapter 9=第 9 章
Chapter 10=第 10 章
Chapter 11=第 11 章
————————界面部分
Difficulty: Normal=难度：正常
Difficulty: Hard=难度：困难
Difficulty: Casual=难度：休闲
————————其它
Cleared to =已完成

I'm cumming=我要高潮了
holy knight=圣骑士
Iris=艾瑞丝
Claret=克莱尔
Ricca=莉卡
Succubus=魅魔
Proceed to stage=游玩关卡
Olivia=奥利维亚

Localized version=本地化版本
build=开发号
Weight=体重
Speed=速度
Save Date=保存日期
seconds=秒
times=次
cowgirl=骑乘体位
Tittyfuck=乳交
Missionary=龙翻体位
doggystyle=狗趴体位
creampie=中出
orgasm=性高潮
Masturbation=手淫
Squat of humiliation:=屈辱的深蹲:
Entry number=录入数目
Drain Crystal=黑暗水晶
Miria=米莉娅
slimes=史莱姆
slime=史莱姆
Polon=Polon
Archlich-大尸巫
Hmm=嗯
Urk=呜
...=...
*Sigh*=*唉*
*Pant*=*喘息*
*Munch*=*咀嚼*
*Chew*=*嚼*
bugs=虫
*Gulp*=*啜饮*
Angle:=角度：
Camera:=镜头：
Default camera=默认镜头
Focal point:=焦点：
Remove focus=移除焦点
Roll: =滚动：
degrees=度
Out of focus threshold:=失焦阈值：
None=无
No.1=1号
No.2=2号
No.3=3号
No.4=4号
No.5=5号
BGM:=BGM：
Auto rotating camera=自动旋转镜头
Fixed dominant partner=固定攻方
POV shot camera=视点镜头
Look at gaze=凝视
Fixed face camera=固定面容镜头
Fixed breast camera=固定乳房镜头
Fixed crotch camera=固定胯部镜头
Fixed backside camera=固定背部镜头
Face=面容
Hip=臀部
Crotch=胯部
Breast=乳房
torso/=躯干
torso=躯干
Slime=史莱姆
Goblin=哥布林
&=和
Stone Golem=石像鬼


Auto distancing=自动距离
area=区域
Auto zoom=自动缩放
camera{{A}}=镜头{{A}}
No.=其
Z Key / 1 Button=Z键/1按钮
X Key=X键
2 Button=2 按钮
C Key=C键
1 Button=1 按钮
Z Key=Z键
11 Button=11 按钮
LeftControl Key=左Ctrl键
12 Button=12 按钮
↑ Key=↑ 键
2- Axis=2- 轴
↓ Key=↓ 键
2+ Axis=2+ 轴
← Key=← 键
1- Axis=1-轴
→ Key=→ 键
1+ Axis=1+ 轴
Attack=袭击
Jump=跳
Move left=向左移动
Special attack=特殊攻击
Walk/Guard=移动/防御
Zキー / JoypadButton1=Z键 / 1 按钮
Hits=击打
Controls=控制
Elapsed time=经过的时间
R-15モード=R-15模式
Hシーン=H场景

<b>Jump</b>\r\n Keyboard:X Key\r\n Controller:3 Button<line-height%3D150%>\r\nHolding the jump button for longer while jumping will raise the height of your jump.<line-height%3D100%>=<b>跳跃</b>\r\n 键盘：X键\n手柄：3按钮<line-height%3D150%>\r\n在跳跃时按住跳跃按钮将提高跳跃高度。<line-height%3D100%>
↑ Key\r\n↓ Key\r\n← Key\r\n→ Key\r\nX Key\r\nZ Key\r\nC Key\r\nV Key\r\nEscape Key\r\nLeftControl Key=↑ 键\n↓ 键\n← 键\n→ 键\nX键\nZ键\nC键\nV键\nEsc键\n左Ctrl键
2- Axis\r\n2+ Axis\r\n1- Axis\r\n1+ Axis\r\n1 Button\r\n3 Button\r\n2 Button\r\n4 Button\r\n12 Button\r\n11 Button=2- 轴\n2+ 轴\n1.轴\n1+ 轴\n1.按钮\n3按钮\n2.按钮\n4按钮\n12按钮\n11按钮
Ladder/Grab chains/Ascend ladder\r\nCrouch/Descend ladder\r\nMove left\r\nMove right\r\nAttack\r\nJump\r\nSpecial attack\r\nWalk/Guard\r\nOpen/close pause menu\r\nFree camera mode=梯子/抓链/爬梯\n蹲下/下梯子\n向左移动\n向右移动\n袭击\n跳\n特殊攻击\n移动/防御\n打开/关闭暂停菜单\n自由镜头模式
↑ Key\r\n↓ Key\r\n← Key\r\n→ Key\r\nX Key\r\nZ Key\r\nC Key\r\nV Key\r\nEscape Key\r\nLeftControl Key=↑ 键\n↓ 键\n← 键\n→ 键\nX键\nZ键\nC键\nV键\nEsc键\n左Ctrl键
2- Axis\r\n2+ Axis\r\n1- Axis\r\n1+ Axis\r\n1 Button\r\n3 Button\r\n2 Button\r\n4 Button\r\n12 Button\r\n11 Button=2- 轴\n2+ 轴\n1-轴\n1+ 轴\n1按钮\n3按钮\n2.按钮\n4按钮\n12按钮\n11按钮
Ladder/Grab chains/Ascend ladder\r\nCrouch/Descend ladder\r\nMove left\r\nMove right\r\nAttack\r\nJump\r\nSpecial attack\r\nWalk/Guard\r\nOpen/close pause menu\r\nFree camera mode=梯子/抓链/爬梯\n蹲下/下梯子\n向左移动\n向右移动\n袭击\n跳\n特殊攻击\n移动/防御\n打开/关闭暂停菜单\n自由镜头模式


